000000010000000
000000000000000
000000000000000
111000000000000
000000011110000
000000010000000
000000010000000
000100010000000
111100010000000
100000010000111
100000000000000
000000000000000
000000000000000
000000000111111
000000000000000
000000000000000
000000000000000
000000100000000
000000100000000
000000100000000
