000000000000000
000000000000000
000000000000000
000100000000000
111100000000000
000000000000000
000000000000000
000000000000000
000100000000000
111100000000000
000000000000000
000000000000000
000000000000000
000000000111111
000000000000000
000010000000000
000001000000000
000000100000000
000000010000000
000000000000000
