000000000000000
000000000000000
000000000000000
000000000000000
000000000000000
111110000000000
000010000000000
000000000000000
000000000000000
000000000000000
000010000000000
111110000000000
000000000000000
000000000000000
000000000000000
000001000000000
000000100000000
000000010000000
000000001000000
000000000000000