000000000000000
000000000000000
000001000000000
000000000000000
000000000000000
000000000111000
111100000000000
000000000000011
000000000000000
000000001000000
000000000000000
000111000000000
000000000000000
000000000000000
000000000000000
000000000111001
000000000000000
000001000000000
000000000000000
000000000000000